|||||||||||||||||||||||||||||||||||||||||||||||||||||||||||||||||||||||||||
|   |   | |   |   |   | | |   |   | | | |       |   | |     |     |   |  x|
||| ||| | ||| ||| | ||| | | ||| ||| | | ||||| ||| ||| | ||||||| | | ||| |||
| | |               | |     | | | |   |   |   |   | |   | | |   | |       |
| | ||| | ||||||| | | ||||| | | | ||| ||| | | ||| | | ||| | | ||||| |||||||
| |     | | | | | |   | | |   |         | | |   |       |   |     |       |
| ||||||||| | | | ||| | | ||| ||||| | | | ||| ||||||| ||| | | ||||| | |||||
|     |         | | |             | | | |       |     | | |     | | |   | |
||| ||||||| | | ||| ||||||||| ||||||| ||| ||| ||| | | | ||| | ||| | ||| | |
|     | |   | |   |   |   | |     |     | | |   | | | |     | | |     | | |
| ||| | ||||||||| | ||| | | ||||| ||| ||||| | ||||||| ||||| | | | ||||||| |
| |   |                 |     |         | | |     |       | | |     | | | |
||||| ||||||||| ||||| ||| ||||||| | ||| | | | ||||| | ||||||| | ||||| | | |
|               |   | | |       | | |           |   |   |   |     |   | | |
| ||| | | | | | ||| ||| | | | | ||||||||||||| ||||||| ||| ||| ||||| ||| | |
| |   | | | | |   |   |   | | |   | | | |   |     | | |   |     | | |     |
| ||| | | ||||| ||| | | ||||| ||| | | | | ||||| ||| | ||| ||| ||| | | ||| |
| |   | | |     |   |   |   | |               |         | |           | | |
||||| | ||||| ||| ||| ||| ||||||||| ||||| | | ||| ||||| | ||| | ||||||| | |
| |   | |     |   |     |           | |   | |   | |           |     | | | |
| ||| | ||| ||||||||| ||||| | ||||||| ||||||| ||| ||||| ||||||| ||| | | |||
|     |   | |         | |   | |       |           | | | |     | | |       |
| ||||| | | ||||| ||||| ||||||||||||| | ||| ||||||| | | | ||||||| ||| | |||
| |     | | |   | |       | |           |   | | |             |   | | |   |
| ||||| ||||||| ||| | ||| | ||||||||| ||||| | | ||| | ||| ||||||| | ||||| |
| |   | |       |   | |     |   |     | |     |     | |       | |     | | |
| | | ||||||||| ||||||||||| ||| ||||||| ||| ||| ||| | ||| | | | | ||||| |||
| | |         |       |   | | |     |   |   |   |   | |   | |   |         |
||||||||| ||| | | ||||||| | | | ||| ||| ||||||||||| | ||| | ||| | | ||| |||
| | | | | | |   |             |   | |   | | |   |   | |   |   |   |   |   |
| | | | ||| | ||| | ||||| ||| ||||| ||| | | | ||||||| | ||| ||| |||||||||||
|             |   | |     |       | |     |     |   | | |     |   |   |   |
||||||| ||| | ||||||||||||||||| | | ||||| ||||| ||| ||||| | | | ||| ||| |||
|   |   |   |     |     |       |   | | |   | |           | | |         | |
||| | ||| | | ||||||| ||||||| ||||| | | | ||| ||| ||| ||||||||| ||||||||| |
| |   |   | | | |   | |   |   | |   | |             |       |       |     |
| | | ||||| ||| ||| | | ||||||| ||| | ||| ||||||| ||| ||| | | | | ||||| | |
|   | |     | |     |     |         | |   |       | |   | | | | |       | |
| ||||||| ||| ||| | ||| | ||||||||| | | ||| ||| | | ||| | ||| | ||| |||||||
|   |   | |     | | | | |   |             | |   |     | | |   |   | |     |
||||||| ||||| ||||| | ||| ||| ||| ||| | | ||| | ||| ||||||| | ||||| | ||| |
|     |   |     |     |         | |   | | |   | |       | | |   |     |   |
||| ||| ||||||| ||||| | | ||| ||| ||||||| | | ||||| ||||| ||| ||| | ||| | |
| |   | |   | |   | |   | |   |   |       | |   |   |       | |   | | | | |
| ||| | | ||| ||| | | | | | | ||| ||| ||| ||| ||| | | ||||||||||| ||| |||||
|   | | | | |   |     | | | | |   |   |     |   | |       |   |           |
| ||| | | | | ||| | | ||||||| ||||| | | ||| | ||| | ||||||| ||| ||||| | |||
| |     | |   |   | | |       |     | |   | | |   |         |     |   |   |
| | ||| | | ||||||| ||||||| ||| | | ||| ||| | ||| | ||| ||| | ||| ||| |||||
|     |           |     | | |   | | | | |   | |   |   | |   | |     |   | |
||| ||| ||| ||||| | ||| | | ||||||||| | | ||||||| ||| | ||| ||||| | | | | |
|     | |   |         | |   |     |     |     |   |   | |     |   | | |   |
| ||||| ||| ||||||| | | | | ||||| ||| | | ||||||| ||||||||||||||| ||||||| |
| |     | |   | | | | | | | |         | | | |       | |   |             | |
| ||||||| | | | | | ||||| | ||| | | ||||||| ||| | ||| | ||||| | | | ||| | |
| | |       | |     | |   | |   | |     |       |       | |   | | | | | | |
||| ||| | | ||||| | | | | ||| ||| ||||||| | ||| ||| ||| | ||| ||||| | ||| |
|       | | |   | | | | | |     | |       | |   |     | |       |       | |
||| | | ||||||| | ||| | ||||||| ||||||| | ||| | ||| ||||| ||| | |||||||||||
|   | | | |   |   |     |   |     | |   | |   | |   | |   | | |           |
| ||| ||| ||| | ||||||||| ||||| | | | | | ||| ||| | | ||| | | | | ||| |||||
| | | |         |     | |       | |   | | |     | |   |   |   | |   |     |
||| ||||||||| ||||||| | | ||||||||||| | ||||||||||| ||| ||||| ||| ||| |||||
|     |   |       | |         |     | |     |       |   |   | |   |       |
||||| ||| ||| ||||| ||| ||| ||||||| ||| | | | | | | ||||| ||| ||| ||||| |||
| |                 |     | |           | | | | | |     |       |   | |   |
| | ||| | ||| | ||||||| ||||| ||||| ||| | | ||||| ||||||| ||| | | ||| ||| |
|     | | | | |   |     |       |     | | |   |     |     |   | |     |   |
||| ||| ||| | | | | ||| | ||| | | | ||| ||| | ||| ||||| ||||| ||| | |||||||
|   |     |   | | |   | | |   | | |   |   | |   | |       |     | |       |
||||| | | | | ||||||| ||||| ||| | ||| ||||| ||||| | ||| ||| | ||| | ||| |||
|     | | | |     |   |       | | |   | |     |   | |     | | |   | |     |
||| ||||| ||||| ||||| | ||| ||||| | | | ||| ||||| ||| ||| ||||||||| ||| | |
|     |   |         | | |       | | |     |   |   |   |           |   | |1|
|||||||||||||||||||||||||||||||||||||||||||||||||||||||||||||||||||||||||||
