|||||||||||||||||||||||||||||||||||||||||||||||||||||||||||||||||||||||||||
|  |   |       | | | |       | | | | |     | | |       |   |   |         1|
|||| | ||| |x||| | | ||||||| | | | | ||||| | | ||||| ||| ||| ||| | | | | ||
|| | | |   | | | |               |     | |       | | |   | |   | | | | | ||
|| ||| ||||| | | ||| | ||||| ||| | | ||| ||||| ||| | | | | | ||| ||| ||||||
|| |   | |   |   | | |   | |   |   | |     |   |     | |   |       | |    |
|| | | | ||| ||| | ||||| | | ||||||||||||| | ||||| ||| ||||||| | ||| ||||||
|  | |   |   | |     |   |       |     |       |   |         | | | | |   ||
|||||||| ||| | ||| | ||||| ||| ||||| ||||| ||||| ||||| ||||||| ||| | | ||||
|  |   | | |   | | | | | | |       |     | | |     | |   | |   |   | |    |
|||| ||| | ||| | | ||| | ||||||| ||| ||||| | ||| ||| | ||| | ||||| ||||| ||
|| | |     | |   |   |     | |   | |   | | | |   | |         |   |   | |  |
|| | | ||||| ||| ||| | ||| | | | | | | | | | | ||| | ||| ||||| ||| | | | ||
|      |   |   |   |     | | | |   | |     | | |     |   |   | |   | |   ||
|||| ||| ||| ||||| | ||||||| ||||| ||| ||||| | | ||||||||| ||| | ||||||| ||
||   | |     | |     |   |       |   |   |             |         | | | |  |
|| | | ||||| | ||||| ||| | ||| | | ||| ||| | ||||||||||||| ||||| | | | | ||
|| |         | |     |   | | | |   |   | | |   |   |   |       | |       ||
|||| ||||||| | ||||| ||| ||| ||||| ||| | ||| ||| ||| ||| ||| ||||| ||||| ||
|    | | |         | |     |   |     |   | | |   |   |     |     |   |    |
|||||| | | | | ||||| ||| ||||| ||||| | ||| | ||| ||| | | | ||||||||||||||||
||   |     | |   |     |   |   | |   |               | | | |     |        |
|||| ||||||||| ||||||| | ||||| | | ||| ||||| ||| ||| | ||||| ||||| ||||| ||
||     |   |     |     |       | | |   | |     |   |         | | | |     ||
|||| ||| ||||| ||||||| | | | | | | ||| | ||||||||||||| ||||||| | ||||||| ||
|      | | |     |     | | | |       |     |       | | | |   |   |     |  |
|| ||| | | ||| ||||||| ||||| ||| ||||| | ||| | ||||| ||| | ||| | ||||| | ||
||   | |       |     |   |   |   | | | | | | | | | |   |   | | | |        |
|||||| ||| | | ||||| ||| ||||||| | | ||| | | ||| | | ||||| | | ||||| | | ||
|| |   | | | | | |   |     | | | |     |         | | |       |   |   | |  |
|| | | | ||| ||| ||| ||| ||| | | | ||||| | | ||| | | ||||| ||| ||||||| | ||
||   |           |   |     |           | | | | | |       | | |   | |   | ||
|||||| ||| | | ||||| ||||| ||||| | ||||| ||||| ||| ||||||| | | ||| ||| ||||
|  | | |   | |   |   | | | | |   | | |   | |   |     | |   |   | | |      |
|||| ||||||||| | ||| | | | | ||| ||| | | | ||| ||| ||| | | ||| | | | | ||||
|  | | | | |   |     | |       |   | | |   | | | | |   | | | | |   | |    |
|| | | | | ||| ||| ||| | ||||| | ||| ||| ||| | | | ||| ||| | | ||| ||| ||||
|| |         | | | |   | | |     |   |   | | | |   |   |   |           | ||
|||||| ||| | ||| | ||| ||| ||||| ||| | ||| | | ||| | ||||| | ||| | ||| | ||
|  |   | | | |           | |       | |   |       |           |   | | | |  |
|||||||| ||| | ||| | | ||| ||||| ||| | ||| ||||||| ||||| ||| ||| ||| ||||||
||   | |       |   | | | | |   |         | |     |     |   | |     | |   ||
|| ||| ||||||||||||||| | | | ||| ||||||||| ||| ||| ||||||| ||||||||| | ||||
|        | | |   | |   |   | |   |         | | |   |   |         |   |   ||
|||| ||| | | ||| | | ||||| | ||| | ||||| ||| | ||| ||| ||||||||||||| | ||||
||   |     | | |       |       |   |   |   |   |       | |   |     | | | ||
|||| ||| ||| | ||| ||| ||| | | | ||||| ||||||| ||| ||||| | ||||| ||| | | ||
|    |   |   |   | | | | | | | | |   |   | | |     | |   | | |     |      |
|||| ||| ||| | ||||| | | ||||| | | ||||| | | | | | | ||| | | ||| | | ||| ||
|| | |         |       | |     |   | | | |     | | |       |   | |     |  |
|| ||||| ||||| ||||||| | ||||| | ||| | | | ||| ||| | ||||| | ||||| | | | ||
|  |   | |       | | |                 |     | | |       | | |   | | | |  |
|| ||| ||||||| ||| | ||||||| | ||||| | | ||||| | ||| ||||||| | ||| ||||||||
|    |               | | |   |   | | |       |   |         |   |          |
|| ||||| | | | ||| | | | ||| ||||| ||| | | | | | ||||| ||||| ||| | ||||| ||
|  | | | | | |   | |               |   | | | | |   |             |   |    |
|| | | ||||| | ||| | | | | | ||||||||| | ||||||||||| ||| ||||| ||| | ||||||
|        | | |   | | | | | |       | | |         |     | | |     | | |   ||
|||| ||| | | | ||| ||||| ||| | ||||| ||| ||| ||||| | ||| | | ||| ||| | ||||
|| | |       | |     | |   | |         | | |   |   |   | |     |   |      |
|| | ||| ||||| ||| ||| | ||| | ||| ||||||| ||||| | | ||||||||||| ||||| | ||
|  |   |   |   | |   | |   | |   |     | | | | | | |           |     | | ||
|| | ||||| ||||| | | | | | | | ||||| ||| | | | ||| ||| ||| | ||||||||| ||||
|| | | |     |     | |   | | |   |         | |   |   | |   |       |   |  |
|||||| | | ||||| | | | | | ||| ||||||| | | | | ||||| ||| ||| | ||||||||||||
|    |   | |   | | | | | | |       |   | |       |     |   | | |          |
|| ||||| ||||| | ||||| | | ||||| ||||| ||||| ||||||| | ||||| ||| ||||| | ||
|  |     |       |     | |   |   |     | |   |   | | | | | |   |   | | | ||
|| ||||| ||||||| ||| | ||| | ||| | ||| | | | | ||| ||||| | ||||| ||| ||||||
|    |     |       | |   | | |   | |   |   |         | | |       | | |    |
|||||||| ||||| ||||||| ||| | | | ||||| ||||||||||||||| | | ||| | | | ||| ||
|| |     |   | | | |     | | | |   |                       | | | |        |
|| | | ||| ||||| | | | | ||| ||| ||||| | | ||| ||| ||||| | | | ||| ||||| ||
|    | |             | | |     | |     | |   |   |     | |   |         | ||
|||||||||||||||||||||||||||||||||||||||||||||||||||||||||||||||||||||||||||