|||||||||||||||||||||||||||||||||||||||||||||||||||||||||||||||||||||||||||
| |   | | |     |       | |   |       |   |     |     |   |         |   | |
| | ||| | ||| ||| ||||| | ||| ||| ||| ||| ||| ||||||| | | ||||| ||| | ||| |
|       |   | | | | | |             | |     | |     | | |   |     | |     |
| ||||| | ||| | | | | ||||| ||||| ||||||| ||| ||||| | ||||| ||| ||||| |||||
| |   |     |   | | |       |       | |   | | |   |       | | | | |     | |
||||| ||| ||||| ||| | ||||| ||||| ||| | ||| | | ||| ||||||| | | | ||| ||| |
| |       |   |   |   | | | |               | |   |   | |         |       |
| ||||||| | ||| ||||||| | ||||||||| | ||| ||| ||| | ||| ||||||| | ||||| |||
|   |     | |     | |   | | |   | | | | |     |     |   | | |   |       | |
||| ||||| | ||| ||| ||| | | | ||| | ||| ||| ||| ||| ||| | | ||||||| | | | |
| |     |     |   | |   | |     |   |         | | | | |           | | |   |
| | ||| ||||| | ||| ||| | ||||| ||||||||| | ||| | | | ||||||||| ||||||||| |
| | | |                 |         |   |   |   | |           |   |   |   | |
| ||| ||||| ||||| ||||| | | ||||| | ||||||||| ||||| ||| ||||||| | ||| ||| |
|         | | | | |       | | | |   |   | |   | |     |     |       |     |
||| | ||| ||| | ||||| ||||||| | ||| ||| | | ||| ||||||| ||||| | | | ||| |||
|   |   | |           | | | |               |     |   |   | | | | | |     |
||||||||| ||||||||||||| | | ||||||| ||||| | ||||| | ||| ||| ||| | | ||| | |
|   | |   | |   | | |           | |   | | |   |   | | | |   | | | |   | | |
| ||| ||| | ||| | | | | ||||| ||| ||||| | ||| ||| | | | ||| | ||||||| ||| |
| |   | | | |     | | |   |     |   |     |     | |         |   |   | |   |
| ||| | | | ||| ||| ||||||| | ||||| ||||| ||| | | ||||| ||| ||| | ||| ||| |
|     | | | |   |   | |     | |   |   |   |   | |   |   | |     | |   | | |
||| | | | | | ||||| | ||||||| | | ||| ||||| | ||| ||||||| | ||| | ||| | | |
| | | | |     | |     |     |   | |   | |   |           |   |   |   |     |
| ||| | ||||| | ||||| ||| | ||||| ||| | ||||| | | ||| ||||||||| | ||||| | |
|               |   | |   | | |   | |         | | |       |   | | | | | | |
||||| | ||||||| ||| | ||| ||| ||| | ||||| ||| ||||| | ||| ||| | | | | | |||
|     | |     | |       |             | | |   | | | | |         |         |
| ||||| ||||| | ||||| ||||| ||| ||| | | ||||| | | ||||||| | ||| | ||| | |||
| |     | | |     | |   | |   | |   |       | |     |     | |     | | |   |
| ||||| | | ||||| | ||| | ||||||| | ||| ||||||| ||| ||| ||||| | | | ||| |||
| |     |   |         |   | | | | | | |   | | | |   |   | |   | | |   |   |
||||||||| ||| | | | | | ||| | | ||||| ||| | | ||||| ||||| | | | | ||| | | |
| | | |       | | | |       |   |       |     |   | | | | | | | | |     | |
| | | | ||||| ||||| ||| | ||| ||||||| ||||| | | ||| | | | | ||||||||| |||||
|         |       | | | |     | |           |     |     |   | |         | |
||||||| ||||| | ||||| ||| ||| | ||| | ||||||||| ||||| | | ||| ||||| | | | |
|   |   |     | |   | | | |       | | |   | |   | |   | | | | |   | | | | |
||| ||||||||| ||| | | | ||||| ||||||||||| | ||| | ||| ||||| | | | | ||||| |
|     | |   | | | |                 | |   |     |     |   |     | |       |
||| ||| ||| ||| ||| ||||| ||||||||| | | ||||||| ||||| | ||||||| ||| |||||||
|       | |   | |   |       |                                   |   |     |
| | | | | | ||| ||| ||||||||||||||| | | ||| ||| | ||| | ||| | | ||| | | | |
| | | |           | | |   |         | | |   | | | |   | |   | |       | | |
||| | ||| ||||| ||||| | ||||| ||||||| ||| | | | ||| ||| ||| | ||||| | |||||
|   | |   | |     | |           | |     | | |   | | |   |   |   |   | |   |
| ||||||||| ||| | | | ||||||| ||| ||| | ||||| ||| ||| | ||| | ||||| ||| |||
|   |           |       |     | |     | |     |   | | |   | | |           |
| ||| | ||| ||||||| ||||||| | | | ||| ||||||||||| | ||| ||| ||||||||| ||| |
| | | | |   |         | |   | |   |     | | |             | |     | |   | |
||| ||| ||||| | | ||||| | | ||| | ||| ||| | | | ||||||| ||||||| | | | ||| |
| | | | | |   | |       | |   | | |     |     | |   |       |   |     |   |
| | | | | | | | | ||||||| ||||| | ||| ||||| ||||| ||||| ||||| ||| ||| ||| |
|   | | | | | | |   |   | |     |   | |       |           | |   |   | |   |
||| | ||| | | | | ||| | ||||| | ||| ||||||| ||| | ||| ||| | ||||| ||||||| |
|           | | | | | |       |   |   | |     | | |   |       |     |     |
||||||||| ||| ||| | | ||| ||||| ||||||| | ||||| | ||||||| ||||| ||||| |||||
|           | |   | | |   |         | | | |     |   |   | | |     |       |
| ||||| | ||||||||| ||||||||||||||||| | ||||| | | | | ||| | ||| ||||| |||||
|   |   |       |                             | | |   |     | | |       | |
||||||| | ||| ||| ||||| ||||| ||| ||||| ||| ||| | | ||| | | | ||| | | ||| |
|       | |     |   |     | |   |   |   |   |   | | | | | |   |   | |     |
| ||||||| | | | | | | | ||| ||||||||| | ||||| ||||| | ||| ||||| | | ||| |||
|   |     | | | | | | | |     |   | | | |     |     |         | | | |   | |
||||||| ||||| ||||| ||||||| ||||| | | ||| | ||| | ||| ||| ||| ||||| | | | |
| |       |       | |                 |   | |   |   | |     |     | | |   |
| ||||||| ||||| ||||| | ||| | ||| | | | | | | ||| | ||| ||||| | ||| ||||| |
|           | | | | | |   | |   | | | | | | | |   |   | |   | | |   |     |
||| | | | ||| ||| | | ||||| ||||| | | ||||||| ||| | ||||| ||| ||||| ||| | |
| | | | | | |           |   | |   | | |     | | | |         | | |   |   | |
| ||| ||||| ||||| | | ||| | | | ||||||| | | | | | | ||||| | | | ||||| ||| |
|     |           | |   | | |   |       | |   |   |     | | | |         | |
|||||||||||||||||||||||||||||||||||||||||||||||||||||||||||||||||||||||||||
