|||||||||||||||||||||||||||||||||||||||||||||||||||||||||||||||||||||||||||
|         |     |       |   |   | | | |     | | | |               |   | | |
||| ||| ||||| ||| ||||||| ||| ||| | | | | ||| | | | | ||||| ||||||||| | | |
|     | |       |     |     | | | |   | | |         |   | | | |   |       |
| | ||| ||||| | | ||||||| ||| | | ||| | ||| ||||||| ||||| ||| ||| ||| ||| |
| | |       | | | |   |     | |     |   | |   | | | |       |   | |     | |
||||||||| ||||| | | ||||||| | ||| ||| ||| | ||| | ||| ||| ||| ||| ||| |||||
| | |   |   |       |       |   |   | |           |   |         |       | |
| | | ||| ||||| ||| ||| | | | ||| ||| ||| ||| | | ||| ||||||||||| ||||||| |
|       |   |   |     | | |     | |   |     | | |         | |       |   | |
||||| ||| ||||||||| ||||||||| ||| ||| | ||||| ||| | ||||||| ||| ||| ||| | |
|         |     |   |     | |       | |     |   | | | | | | | |   | |   | |
| ||||| | ||||| ||| ||| ||| ||| | ||| | ||| ||||||||| | | | | | ||||| ||| |
| |   | |   |           |     | | |       | |   |   |   | |   | | | | | | |
||||| | | ||| ||| ||||| ||||| | ||||||| ||||| ||||| | | | | ||| | | | | | |
| |     | | | |   |     | | |                   |   | | |   | | |     |   |
| ||| ||| | ||||| | ||| | | ||||| ||||||| ||| ||||| | ||| ||| | ||| ||| |||
|       | |   |   | |     |   |     | | | | |               |   | |   |   |
||||| ||||| ||||||||| ||| | ||||| | | | | | ||||| | | | ||||| ||| | ||| |||
|         |   |   |   |   |     | |     |       | | | |   | | | | | |     |
||||| ||||| ||||| ||||||| | | ||| ||||||||||| ||||||||||||| | | | | ||| |||
| | |   | | | | | |   |     | |   |   | |   | |     | |   |         | |   |
| | | ||| | | | | ||| | | ||||||| | ||| | ||| ||| ||| | ||||| ||||||| | |||
|   | |   | | | | |     | | |               | |           |       | | |   |
| | | ||| | | | | | ||| ||| ||| ||||||||||||||||||| ||||||| | ||||| | | |||
| |   | |       | | | |     |     | |   |     |         |   | | | |       |
| ||| | | ||||| | ||| | ||||||| ||| | ||| ||||||||| | ||| ||||| | | |||||||
|   | | | | | | |     |     | |   | |       | |     |       |       |     |
| ||||| ||| | | ||| | ||||| | | | | | ||| ||| ||| ||||||| ||| ||||||| ||| |
| |   | |         | | |         |       | | |         | | |   |         | |
| | ||| ||||||| ||| ||| ||| | ||| ||||||||| ||| ||| | | ||| ||| |||||||||||
| | |   |   | |   |     | | |   |   |     | |     | | |   | |     | | | | |
| | | ||| ||| ||| | ||||| ||||||| ||||||| | | | | ||||||| | | | | | | | | |
|       |   | | |     |   |     | | | |       | | |         | | | |       |
| | ||| | ||| | | ||||| ||||| ||||| | | | | ||||||||||| | | | ||||| ||| |||
| | |       |             |           | | |     |       | |           |   |
||||||||| ||||| ||||| ||||||| ||||| ||||||| ||||| | ||| ||| |||||||||||||||
| |       | |   | | |   | | |     |   |   | | | | | | | | | |   |     | | |
| ||||| | | ||| | | ||||| | | ||||||||| ||| | | | ||| ||| ||| ||| ||||| | |
|       |       | |     |         | |   | | |   | | |     | |   | | |     |
||| ||||| ||||| | | ||||| | | ||||| | ||| | | ||| | ||| ||| | ||| | ||| |||
|   |   | |   | | |   | | | |   | | | |   |           |   |         |     |
||| ||| ||| ||| | | ||| ||| ||||| | | | ||| ||| ||||||| ||||| ||||||||| |||
| | | | | |     | | |   |         | |   |     | | | | |   |   |     |   | |
| ||| | | ||||| | | | ||| ||| ||||| | ||| ||||||| | | | ||| | ||| ||| | | |
|   |       |     | |     |                               | | | | | | | | |
| ||||||||| ||| | | | ||| ||| ||||| ||| ||| ||||||||| ||||| ||| | | | ||| |
| | |   |   |   | | |   | | |     | | |   |       |     | | | |   |       |
| | ||| ||| ||||| | | ||||| | ||||||| ||||||||||||||| | | | | | ||| |||||||
|   |     | |               |       |   | |   | |   | |                 | |
||| ||||| | ||||| ||| | ||||||||||||||| | | ||| ||| | ||||||| ||||||| ||| |
|   |   | | | | | |   | | |   | | | |       |       | | |   | | | | | | | |
||| ||| | | | | | ||||||| | ||| | | ||| | | ||| ||| ||| | | ||| | | ||| | |
|   | |     | | |                       | |     | |     | |               |
||| | | ||| | | | | | | | ||||| | ||| ||| ||||| | ||||| ||| ||| ||||||||| |
| | |     |       | | | |   | | | |     | | | | |   |         |       | | |
| | ||| ||||||| ||| ||||||||| | ||||||| ||| | ||| ||| | ||| | ||| | ||| |||
|     |   |     | |         | |   | |               | |   | | |   |   |   |
||| | | ||| | | | ||||| | ||| ||||| ||| ||||| ||| | ||| ||| ||||||||||| |||
| | | | | | | |     | | |         |   | |   | |   | | |   |   | | |   | | |
| ||| | | ||||| | ||| ||| ||||||||| | ||| | ||| | ||| | | | ||| | | ||| | |
|           |   |       |           |     | | | | | |   | |   |   | |     |
| | | | | ||||||| | | | | ||| | | ||||| ||| | ||| | ||| | | | | ||| | | | |
| | | | | |     | | | | |   | | |     | |       |     | | | |         | | |
| ||||| ||| ||||| ||| | ||| | ||| ||| | ||| | ||| ||||| ||| | ||| | | |||||
| | |         |   |   |   | | |   |   | | | | | |   |     | |   | | | |   |
| | | | | ||| ||| ||||| ||||| ||||||| ||| ||||| ||||||| ||||| ||| ||| ||| |
| |   | | |     |   |     | | | | |           |     |     |   |   | |     |
||||| ||| ||||||| ||||| ||| | | | ||| ||||| ||| ||||||||||| | ||| | ||||| |
|     |         |   |   | |         |     | |             | | |       | | |
| ||||| | ||||||| ||| | | ||| | | ||| ||| ||| | ||||| ||||||| | | | ||| | |
| |   | |       |   | |     | | |   | |       |   |   |   | | | | |     | |
| ||| | ||| ||||||| | ||| ||| ||||| | ||| ||| ||||| | ||| | ||| | | | |||||
| |       |     |   | |     |     | |   | |       | |       |   | | |     |
|||||||||||||||||||||||||||||||||||||||||||||||||||||||||||||||||||||||||||
