|||||||||||||||||||||||||||||||||||||||||||||||||||||||||||||||||||||||||||
| | | ||||| ||| | | | ||||| | | | ||||| | ||| | | | ||||| | | | | ||||| |||
| | | |     |       | |     | | | | |       |   |     |   | |     |       |
| ||||||| ||| | | | ||||| ||| ||| | ||||||| | ||| ||||| ||||| | | | | | |||
| | |   |   | | | | |     |                 | | | | |   | | | | | | | |   |
| | | ||| ||||| ||| ||| | | | ||| | ||||||| | | | | | ||| | ||| ||| ||| | |
| | | |     | | |     | | | |   | | |     |         | |   |   |   | | | | |
| | | ||| ||| ||||| ||||||| ||||||||||||| | ||||||| | | ||| | | | | | |||||
|   |   |                 | |       | |       |         | | |   | | |   | |
||| ||| ||||| ||||||| | ||||||||| | | | ||| ||||||||| | | ||||| ||| | ||| |
|   |   |   | |       | | |   |   | |   |     |       | | |   |     | |   |
||| | | | ||| ||||| ||| | | | ||| ||| ||||||||||||||| ||| ||| | ||||| | |||
|   | |     | |     |   | | | |   | | |               |   | |       |     |
| | ||||||| ||||||||||| | | ||||| | ||||||| ||||| ||| | ||| ||| ||||||||| |
| |     |     | |       |   | | | |   | | | |   |   |   |     | | | |   | |
||| | ||||||| | | ||||| | | | | | ||| | | ||||| ||||| | ||| | | | | ||| | |
| | | |   |     | |     | |     |   | |       | | | | |   | |   |   | | | |
| ||| | ||||| ||||||||| ||||| ||| ||| ||||| ||| | | | | ||||| ||| ||| | | |
|                     |       | | |   |     | | |     | |       |     | | |
| ||| ||||||||||| ||| ||| ||| | | ||| ||||| | | | ||| ||||||| ||||||| | | |
|   | |   | |   | |       |     | | |   | | | | | |           |     |     |
| ||| ||| | ||| ||| | ||||||||| | | | ||| | | | ||||||||||||| ||| ||| |||||
| |     |   |   |   | |           | |           |   |       | | | |       |
||| ||||||| ||| | ||||||| | | ||| | ||| ||||| | ||| ||| | ||| | | ||| | |||
|   |         |     |     | |   |         |   |       | | |     | |   | | |
||| ||||||||| ||||||||| ||| ||||||||| ||||| | ||||| | ||| ||| | | | ||||| |
|   |   | |         | | |   |     | | | | | | | |   |         | |   | |   |
||||||| | ||| ||||| | | | ||||||| | ||| | ||||| ||||||||||| ||||| | | ||| |
|     |   |   |       | | | |                   |               | | |     |
||| ||||| ||| ||||||| ||||| ||||| ||||||| ||||| ||||| ||||||| ||| | | |||||
|   | | |     |               | |   |   | | |   |   | |         | | |   | |
||| | | ||||| | ||||||| ||||||| ||||||| ||| ||| ||| ||| ||| | ||| ||| ||| |
|       | |   | |         | | |   |   | |     | |     | |   |             |
||||||| | ||||| ||||| ||| | | | ||||| | ||||| | ||||| ||| ||| | | |||||||||
|     | |     | | | |   |           |               |   | | | | |   | |   |
||| ||| | ||||||| | | ||| ||| | ||| | | | ||||||||| | ||||| ||| ||||| | |||
| | | |     |   | | | | |   | | |     | | | | | |       | | |       |   | |
| | | ||| ||||| | | | | ||| | ||||||| ||||| | | ||| | ||| | ||| ||||| | | |
|                       |   | |       |   |       | |         |       |   |
| | ||||||||||| ||| | ||||||||||||||||||| | | | ||||| | ||||||||| ||||| |||
| | | | | |       | | | |   | |             | | | | | | |   | |       |   |
||| | | | ||||| | ||| | | ||| ||||||||| ||| | | | | ||| ||| | | ||| | | |||
| | |           | |   |             |   |   | |     |   |         | | |   |
| ||| | | ||| ||||| ||| | | ||||| | ||| ||| ||||||| ||| | | ||| ||||| |||||
|   | | |   | |       | | |   |   |     |   |             | |     |       |
||| | ||| | | ||||||| | ||||||||||||| | ||| ||||||||| | ||| ||| | ||||| |||
|       | | |       | | | |       |   | | | |   |     | |   |   | |   | | |
| ||| ||||| ||| ||| ||||| | ||||| ||||| | ||||| ||| ||| ||| | ||||| ||||| |
|   |     | |   | |     |     |   | | | | | |         | |   |             |
| ||| ||||||||| | | | ||||| ||||| | | ||| | ||| ||| ||||||||| ||||||| | |||
| | | | |   |   | | | |   | |       |   | | |     | |               | |   |
||| ||| ||| ||||| | | ||| ||||||||| | ||| | ||| ||||||||| ||||| ||| | ||| |
| |       | | |   | | |                   | | | | |   |       |   | |   | |
| ||| ||| | | ||| ||||| ||||||||||||| | | | | ||| ||| ||| ||| ||| ||||| | |
|       | |       | |     |           | |                   |   |   | | | |
||||||||| ||||||| | ||||||||||| ||| ||| | ||||| | ||||| | ||| ||||| | |||||
|   |         | | |   | |   |   |   | | | |   | | | | | |   |   |       | |
||| ||| | | ||| | | ||| ||| ||| ||||| ||| | | ||||| | | ||| ||||| | | ||| |
| | | | | |               |     |       | | |             | | |   | |     |
| | | ||||||||| | ||| | | ||||| ||| ||| ||||| | ||||| | ||||| | ||| | ||| |
| | | | | |     |   | | |         | | |       | | | | |       | | | |   | |
| | | | | | ||| ||||||||||| | | ||| | ||| ||| | | | ||| | ||||||| | | | | |
|   | | | |   | | |   |     | | |   |       | | |       |   |   | | | | | |
||| | | | | ||| | ||| ||||||| ||||||| ||| ||||| ||||| ||||| | ||| |||||||||
|           |     | |     |   |   |   |     |   | | |   |             | | |
| | ||| | ||| ||||| | ||||||| | | | | ||||| ||| | | | ||| ||| | ||| | | | |
| | |   | |   | | |   |     | | |   |   |     | |       | |   | | | | |   |
| | ||| | ||| | | ||| ||||| | ||| | ||||| | ||||||| ||| ||||| ||| | ||||| |
| | |   | |   |               | | |   |   |   |       | |     |           |
| ||||| ||||||||| ||| | | ||| | | | ||| ||| ||||| | ||| | | ||| ||| ||||| |
|     | |   | | | |   | | |   |   | |   |   |   | | |   | |   | |       | |
| | | ||| | | | ||| ||| | | | ||| ||||| | | ||| ||||| ||| | ||| | | | | | |
| | |   | |         |   | | |   | |     | | | |       | | | |   | | | | | |
| ||| | | ||| ||||| ||||||||||||||| | | ||| | | | ||| | ||| | ||||| ||||| |
|||||||||||||||||||||||||||||||||||||||||||||||||||||||||||||||||||||||||||
