|||||||||||||||||||||||||||||||||||||||||||||||||||||||||||||||||||||||||||
|||||| | ||| ||| ||| | ||||| ||| ||| ||| ||| | ||| ||||| | | ||| ||||| ||||
|    |   |   | | |       | | |   |   |           | |       |       |     ||
|| | ||| ||| | | ||||| ||| | ||| | ||||| ||||||||||| ||||||||||| | ||| ||||
|  | | |   |     |   | |   |   |   | |                   |   | | |   | |  |
|| ||| | ||||| | ||| | ||| | ||| ||| ||| ||||||||||||||||||| | ||| ||| | ||
||   |       | |   |   |       |   |     |   |           | |   |     |    |
|| | ||||| ||| ||||||| ||||| ||||| | | | | ||| ||| | ||| | ||| | ||||||| ||
|| |   |           |           | | | | | |   |   | |   | |   |     |     ||
|||| ||||||||||||| ||| | ||| ||| | | ||||| ||| ||||||||||| ||||| ||||| | ||
|| |   |   |         | | |     |       |   |   | | | |   |   |   |   | |  |
|| ||| | ||||||||| ||||||||| ||||||| ||||| | | | | | | ||| ||||| ||| ||| ||
||   |   | | |       | | | | | | | | |     | |       |     |   |   |      |
|||| | ||| | ||| | ||| | | | | | | | ||||| | ||| ||||||| ||| ||| ||||| ||||
|| | | | |     | |   | | | |       |   | | | | | |     |       |   | |    |
|| | | | ||| ||||| ||| | | ||||||| | ||| | | | ||||||| | | ||||||| | | ||||
|  | |   |   |     |         | | |   | | | | | | | | |   | | | | |   |    |
|| | | ||||| ||||| ||||| | ||| | | ||| | | | | | | | | ||||| | | ||| | ||||
||   |   |     |   |   | | | | |                 |   |   | | | |         ||
|||| | | | ||||||| | ||||| | | | ||||| ||||||||| ||| | ||| | | ||| ||||||||
||   | |   |   |   |     |     |   |   |   |   | |     | |       | |   | ||
|||| ||||| | ||||| ||| ||||| ||| | ||||||| ||| ||||||| | | | ||||| | ||| ||
|    |   |   | |   |     | | |   |   |         |   |     | | | |          |
|||| | ||| ||| | ||||| ||| | | | ||||||| ||| | | ||||| ||| ||| | ||||||||||
||     |   |   | |   | | |     | | | |   | | | | |     |     | |         ||
|||||| ||| ||| | | ||| | ||| ||||| | ||| | ||||| | | ||||| ||| | ||||||||||
|  |     |       | |   | | | |     | |       |   | |   |   |   | | | |    |
|||||| ||||||||| | ||| | | | | ||||| ||||| ||||| ||||| ||| | ||| | | | ||||
|          | |     |     | |     |     |         |             | |     |  |
|||| ||| ||| ||||| ||||| | ||| ||| ||||||||| ||||||| | | | | ||| | ||||| ||
|    |     |   | | | |                 | |     | | | | | | |   | | |   | ||
|||||||| | | | | | | ||||| | | ||||||||| | | | | | | ||||| | | | | | ||| ||
||   |   | | |   |     | | | |     |     | | |   | | |     | |     |      |
|| ||| | ||||||| | | ||| ||| ||||||||| | | ||| ||| | ||||| ||||||||| ||||||
|    | |     | | | |     | |   |     | |   | | |         |           |   ||
|| ||||||| ||| | ||| ||||| | ||| ||||||| ||| | ||||| | ||| ||| ||||| ||| ||
|    | |       |     | |       | | | | | |   | | | | | |     | | |     | ||
|| | | ||||||| ||| ||| ||| ||||| | | | | ||| ||| | | ||||||||||| ||||| | ||
|| | |   |     | | |   | | | | | |   |   | |         | |   |   |     | |  |
|| ||||| ||||| | | | ||| | | | | ||| | ||| | ||||||| | | ||| ||||| ||||| ||
|    |   | | |       |   |                   | | | |         |   | | | |  |
|||| | ||| | ||| ||||||| ||| | ||| ||| | ||| | | | | | ||| ||||| | | | | ||
|  |   |   |         |     | | | |   | | |         | | |   |   | |       ||
|| | | ||| ||| ||||| ||||| | ||| ||||||||||| ||||||||||||||| ||| | ||||| ||
|| | |       |     | | |         |         |       |         |         |  |
|| ||||||| ||| ||||||| ||| ||||||| ||| ||||||| ||| | ||||||||||||||| ||||||
||           |     | | |   |         | | | |   | |       |   |   | |     ||
|||||||| | | | ||||| | ||| | | ||||||||| | ||| | ||||||||| ||| ||| | ||| ||
|    | | | | | |   |     | | | | | |   |   | |   |   | | |             |  |
|| ||| | | | | | ||||| ||| | ||| | | ||| ||| ||||| ||| | | ||| | | | ||||||
|  |   | | | |   |       |   |   |   | | | | |     |   | |   | | | |     ||
|| ||| ||||| | ||| | ||||| | ||| ||| | | | | | ||||||| | | ||||| ||||||| ||
|    | | |   | |   | | |   |   |                 | | | |   |   | | |   | ||
|||| | | ||| | ||| ||| ||| ||||| ||| ||||||| ||||| | | | | | ||||| | ||||||
||   | | | |     |         | |     |     | |   | |   | | |             | ||
|||| | | | | ||||||| ||||||| ||| ||||||||| ||||| | ||| ||| ||||| ||| ||| ||
|| |       | |   | |       | |   |   |   |   | |   |   | | |   |   | |    |
|| ||||| ||| ||| | | ||||||| ||| | | | ||| ||| | ||| ||| | ||| ||||||| ||||
|  | | |     |             | |   | | |   | | |   |   |       |            |
|||| | ||| ||| | ||||||||||| | ||| ||| ||| | ||| ||| | ||| | | ||| ||| | ||
||   | |     | | |   | | |         |     |               | |     |   | | ||
|||| | | | ||||| ||| | | ||| ||| ||| | | ||| | | ||| ||||| | | ||||| ||||||
|      | |                     |     | | |   | | |       | | | | | | | |  |
|||||| ||||| ||| | ||| ||| | ||||||| ||||||| ||||||| ||||||||||| | ||| ||||
||     |       | |   | | | | |   | |   |         | | |         | |        |
|||||| | | ||||||||||||| ||||| ||| ||||| ||| ||| | ||| ||||| ||| | ||||||||
||       |             |   | | |           | | | | | | | |             |  |
|||||| ||| | ||| ||||| | ||| | | ||||||| ||||| | | | | | ||||||||||||||||||
|      |   |   | |   |                 | | |   | | |   | |     |   |      |
|| | | ||||| ||||||| ||| ||||||||||||| | | | ||||| | ||| | ||||| | ||||| ||
|| | | |               |             | | |   |   |               | | |   ||
|||||||| | | ||||| ||| ||||| | ||||||||||| ||||| | | ||| | | ||| ||| ||| ||
|        | |   | | |       | |             |       |   | | |   |          |
|||||| | ||| | | | ||||||| ||||||| ||| ||||| | ||| ||||| ||| | | ||| | | ||
|||||||||||||||||||||||||||||||||||||||||||||||||||||||||||||||||||||||||||
