|||||||||||||||||||||||||||||||||||||||||||||||||||||||||||||||||||||||||||
|  | |       |             |   |     |       | | | |         |            |
|| | ||| | ||| ||| | ||||||| ||||| ||||||| ||| | | | | ||||||||| ||||||||||
|    |   | | |   | |         | | | | |       | | |   |     | | |   |   |  |
|| | | ||||| ||||||||||| ||| | | | | ||| | ||| | | ||||||||| | | ||| ||| ||
|| |       | | |       |   |     |     | | | |   |   | | |   | | | | |    |
|||||| ||||| | | ||||| | ||||||||||| ||| ||| | ||| | | | | ||| | | | | | ||
||   | |   | | | |         |     | |     | |       |   |   |   |       | ||
|||| | ||| | | ||||||| ||||||| ||| | ||| | ||| ||||||||||| | | | ||||||||||
|  |   | |   |   |   | |   |   |     |     |         |   |   | | |     | ||
|| | | | | ||||| ||| | ||| ||| ||||| ||| ||||| ||| | | ||||| ||| ||| ||| ||
|| | | |     |   | |   |           | |         | | | | | | |              |
|| ||| | ||||||| | ||| ||||| ||||||||| | | ||||| ||||| | | ||||| ||| ||||||
|  | | | | |             |       | | | | | | |       |     | |   |   | | ||
|| | | | | ||||| ||||| ||||| ||||| | ||| ||| | ||||||| ||| | ||| ||||| | ||
|  | | |   | |   | | |     | | | | |   |     |   | | |   |   |       |    |
|| | | ||| | ||| | | ||||| | | | | | ||| | | | ||| | | ||| ||| ||||||| ||||
|    | | | | |   |   | |     |     | | | | |       |     | | | | | | |   ||
|||| | | | | ||||| ||| ||| ||||| ||| | | ||||| ||||| ||||||| | | | | | | ||
|            |     |   | |   | | |   | |   | |   | |   |   |     | | | |  |
|||||||| | ||||||| ||| | | | | | ||| | | ||| ||||| | ||| ||| ||||| | | ||||
||       |   | |       |   | |               | | | |   | | |   |   |      |
|| ||||| ||| | ||||||| ||| ||| ||||| | ||||||| | | | ||| | | ||||| ||| ||||
|| |   | | | | | |   | | |         | | | | |   | |         | |   | |   |  |
|||| ||| | ||| | ||| | | ||| | ||| ||||| | | ||| | | ||||| | ||| | ||| ||||
|  |   |   | |   | |         | |           |   |   |   | | |   |          |
|| | ||| ||| | ||| | ||||| ||||| ||||||| ||||| | | ||||| ||| ||| ||||| | ||
||   | |     |   | | |   | | | | | |   | | | | | | |           |   |   |  |
|||| | ||| ||||| | ||||| | | | ||| ||| ||| | | | | ||||| ||| ||| ||||||| ||
|  | |       | |   | |   | |     | |   |       | | |   | | |   |   | | | ||
|| | ||| ||||| | ||| | | | | ||||| ||| ||||| ||| ||| ||| | ||||| ||| | ||||
||   |           | | | | |       |   | | |     |   |       |         | |  |
|||| | ||| ||| ||| | | ||| | ||||| ||| | | | ||| ||| ||||| ||||| ||||| | ||
|| |     | | | | | |   |   |   |   |       |           |                  |
|| ||||||||| | | | ||| | ||||| | ||||| ||||||| | | ||| ||| ||||||||| ||| ||
|  | | | |         |     | | | |       | | |   | | |   |           | |   ||
|| | | | ||||||| | ||||| | | ||| | ||||| | ||| ||||||| ||||| | | ||||| | ||
||     |     |   |   |     | |   | | | |     |   | | |     | | |     | |  |
|| ||||||||| ||||||| ||| ||| ||| ||| | | ||||||||| | ||||||||| ||||||||| ||
|        |   | |       | |   |     |       |   |   | |   |   |       |   ||
|||| ||||||| | | ||| ||| | ||| ||||| | ||||||| ||| | | | | ||||| ||| | | ||
|  |   | |     | |   | |   |     |   |     |         | | |     | |   | | ||
|| ||| | ||||| ||| | | | ||| ||||||| ||||||||| | ||| | ||||| ||||||||| ||||
||       |   | | | |           |   |         | | | |             | |      |
|||||||| | ||| | ||| | | ||| ||| ||| ||||||||| | | ||||| ||| ||||| ||| | ||
||   |       | |     | |   |                 | | |     |   |     | |   | ||
|| ||||| ||||| ||||||| ||||||| ||| ||| ||| ||| ||||| ||||| | ||||| ||||||||
|          | | | |   |       | | | | |   |           | | | |             ||
|||||| | ||| | | ||| ||| | ||||| ||| ||||||||| | ||| | | ||||| ||| ||||||||
|| | | |         |     | | |           | |   | |   |     |   |   |   |    |
|| | ||| ||| ||||||||| | ||| ||||| | | | | ||||| | ||| | | | ||| ||||| ||||
|    |   | | |   | | |     |   | | | |         | |   | |   | |     |   | ||
|||| ||| | | ||| | | | | ||| ||| ||||||| ||||||||||| ||||| ||||||||| | | ||
|  | |   |             |             |             | | | |     | | | | |  |
|||| | | ||| ||| ||| ||| ||||| | | ||||| ||| ||||||||| | ||||||| | | ||| ||
|      | |     |   |   |     | | |     | |                 | | |       | ||
|| | | ||| | | | ||| ||||| ||||| ||||||||||| ||| | ||||| ||| | | | ||||| ||
|  | |   | | | | | | | |     |     | | | |     | | |   | | |     | | |    |
|||||| ||||||||| | | | ||| ||||||||| | | ||| ||||||| | ||| | | ||||| | | ||
|      | | |     | | |                   | | | |     |   | | | | | |   | ||
|| | | | | | ||| | | ||| | | | | ||||||||| | | | ||||||||| ||| | | | ||||||
|| | | |     |     |   | | | | |         | | | |     |     | |       |    |
|| ||||| | | ||| | ||||| | ||||||| ||| ||| ||| | ||| ||| | | | | ||||| ||||
|  |     | |   | |   |   |   | |     | |   | | |   |   | |     | | |   | ||
|||||| ||||| ||||| ||| | ||| | | | | ||| | | | | ||||||||||| ||||| | ||| ||
|      |       |     | | |     | | | |   | | |   | |   | | |              |
|||||| ||||| ||||| ||| ||||| | ||| ||| ||||| | ||| | ||| | | ||| ||| ||| ||
|      |     |     |     | | | |           | | | | |   |       | |   | | ||
|||||| ||||||| ||||| | ||| ||||||| ||| ||||| | | | | ||| | ||| | | | | ||||
|      |         |   |         |     |                   |   | | | |      |
|||| ||||| ||||| ||||| ||| ||||||| ||||||| | | ||||| | | | | ||| ||| | | ||
|        |   |   |     | | |   |       | | | |   |   | | | |   | |   | | ||
|| | | ||||||| | ||| | | | | ||||| ||| | ||||| ||| | ||| ||||||||||||| ||||
|| | |     |   | |   |   |       |   |       |   | | |           |        |
|||||||||||||||||||||||||||||||||||||||||||||||||||||||||||||||||||||||||||
