|||||||||||||||||||||
|                   |
|                   |
|                   |
|                   |
|                   |
|                   |
|                   |
|                   |
|                   |
|                   |
|                   |
|                   |
|                   |
|                   |
|                   |
|           |   ||| |
|            | |    |
||||       | | ||||||
|x         | |      1
|||||||||||||||||||||